aaaaaaaaaaaaaaaaaaaaaaaaaaaaaaaaaaaaaaaaaaaaaaaaaaaaaaa
a0a00aa00a0a00aa00a0a00aa00a0a00aa00a0a00aa00a0a00aa00a
a0000aa00a0000aa00a0000aa00a0000aa00a0000aa00a0000aa00a
a00a00000a00a00000a00a00000000a00000a00a00000a00a00000a
a0000a0a0a0000a0a0a0000a0a0a0000a0a000000a0a0a0000a0a0a
a00a00000a00a00000a00a00000000a00000000a00000a00a00000a
a00a00000a00a00000a00a00000a00a00000a00a00000a00a00000a
a00a00000a00a00000a00a00000a00a00000a00a00000a00000000a
a0aa00000a0aa00000a0aa00000a0aa00000a0aa00000a0aa00000a
a0a00aa00a0a00aa00a0a00aa00a0a00aa00a0a00aa00a0a00aa00a
a0000aa00a0000aa00a0000aa00a0000aa00a0000aa00a0000aa00a
a00a00000a00a00000a00a00000000a00000a00a00000a00a00000a
a0000a0a0a0000a0a0a0000a0a0a0000a0a000000a0a0a0000a0a0a
a00a00000a00a00000a00a00000000a00000000a00000a00a00000a
a00a00000a00a00000a00a00000a00a00000a00a00000a00a00000a
a00a00000a00a00000a00a00000a00a00000a00a00000a00000000a
a0aa00000a0aa00000a0aa00000a0aa00000a0aa00000a0aa00000a
a0a00aa00a0a00aa00a0a00aa00a0a00aa00a0a00aa00a0a00aa00a
a0000aa00a0000aa00a0000aa00a0000aa00a0000aa00a0000aa00a
a00a00000a00a00000a00a00000000a00000a00a00000a00a00000a
a0000a0a0a0000a0a0a0000a0a0a0000a0a000000a0a0a0000a0a0a
a00a00000a00a00000a00a00000000a00000000a00000a00a00000a
a00a00000a00a00000a00a00000a00a00000a00a00000a00a00000a
a00a00000a00a00000a00a00000a00a00000a00a00000a00000000a
a0aa00000a0aa00000a0aa00000a0aa00000a0aa00000a0aa00000a
a0a00aa00a0a00aa00a0a00aa00a0a00aa00a0a00aa00a0a00aa00a
a0000aa00a0000aa00a0000aa00a0000aa00a0000aa00a0000aa00a
a00a00000a00a00000a00a00000000a00000a00a00000a00a00000a
a0000a0a0a0000a0a0a0000a0a0a0000a0a000000a0a0a0000a0a0a
a00a00000a00a00000a00a00000000a00000000a00000a00a00000a
a00a00000a00a00000a00a00000a00a00000a00a00000a00a00000a
a00a00000a00a00000a00a00000a00a00000a00a00000a00000000a
a0aa00000a0aa00000a0aa00000a0aa00000a0aa00000a0aa00000a